NO ./textures/brick.xpm
SO ./textures/brick.xpm
WE ./textures/brick.xpm
EA ./textures/brick.xpm
F 220,100,0
C 225,30,0
1111111111111111111111111
10E0000000110000000000001
1011000001110000000000001
100100000000000000000000111111111
111111111011000001110000000000001
100000000011000001110111111111111
11110011111111011100000010001
11110101111111111101010000001
11000000110101011100000000001
100000000001000011000000100011
100000000000000000010100D00001
110000011101010111110111100011
11110111 1110101 1011110100001
11111111 1111111 1111111111111
