NO ./textures/brick.xpm
SO ./textures/cave.xpm
WE ./textures/stone.xpm
EA ./textures/wood.xpm
F 220,100,0
C 225,30,0
11111111111111111111111111
10W00000001000000000000011
10110001D11D10000000000001
100100000000000000000000011111111
11111D111011000001110000000000001
100000000011000001110011111111111
100000000011100111000000111111
111111111111100111000000000001
110000001101000110000001100001
100000000001000000000001100011
100000000000000000110000000001
110000011101010111110111100011
111101111111010111011110100001
111111111111111111111111111111
