NO ./textures/brick.xpm
SO ./textures/cave.xpm
WE ./textures/stone.xpm
EA ./textures/wood.xpm
F 220,100,0
C 225,30,0
11111111111111111111111111
10W00000001000000000000011
10110001D11D10000000000001
100100000000000000000000111111111
11111D111011000001110000000000001
100000000011000001110111111111111
11111111111111011100000010001
11110001111111111101010000001
11000000110101011100000000001
100000000001000011000000100011
100000000000000000010100000001
110000011101010111110111100011
11110111 1110101 1011110100001
11111111 1111111 1111111111111
